#############
#           #
#      ..   #
#           #
#    ??     #
#*          #
#############
